N_nodes,lambda,h,T_max,total_healthy,total_contagious,total_ill,total_dead,total_recovered,contagious_percentage,ill_percentage,death_percentage,avg_iterations_to_die,diff_contage,diff_deaths,sum_of_diffs
3000,0.05,0.3,3,115,2885,2885,197,2688,0.96,0.96,0.07,3.17,1685,13,1698
3000,0.05,0.3,4,98,2902,2902,298,2604,0.97,0.97,0.1,3.74,1702,88,1790
3000,0.05,0.3,5,101,2899,2899,407,2492,0.97,0.97,0.14,4.38,1699,197,1896
3000,0.05,0.3,6,89,2911,2911,494,2417,0.97,0.97,0.16,5.06,1711,284,1995
3000,0.05,0.35,3,63,2937,2937,195,2742,0.98,0.98,0.07,3.15,1737,15,1752
3000,0.05,0.35,4,61,2939,2939,270,2669,0.98,0.98,0.09,3.85,1739,60,1799
3000,0.05,0.35,5,56,2944,2944,381,2563,0.98,0.98,0.13,4.37,1744,171,1915
3000,0.05,0.35,6,47,2953,2953,531,2422,0.98,0.98,0.18,5.02,1753,321,2074
3000,0.05,0.4,3,14,2986,2986,214,2772,1.0,1.0,0.07,3.21,1786,4,1790
3000,0.05,0.4,4,26,2974,2974,311,2663,0.99,0.99,0.1,3.74,1774,101,1875
3000,0.05,0.4,5,27,2973,2973,428,2545,0.99,0.99,0.14,4.46,1773,218,1991
3000,0.05,0.4,6,14,2986,2986,516,2470,1.0,1.0,0.17,4.87,1786,306,2092
3000,0.05,0.45,3,7,2993,2993,225,2768,1.0,1.0,0.07,3.26,1793,15,1808
3000,0.05,0.45,4,11,2989,2989,278,2711,1.0,1.0,0.09,3.84,1789,68,1857
3000,0.05,0.45,5,9,2991,2991,449,2542,1.0,1.0,0.15,4.35,1791,239,2030
3000,0.05,0.45,6,8,2992,2992,507,2485,1.0,1.0,0.17,5.04,1792,297,2089
3000,0.05,0.5,3,5,2995,2995,188,2807,1.0,1.0,0.06,3.24,1795,22,1817
3000,0.05,0.5,4,4,2996,2996,275,2721,1.0,1.0,0.09,3.76,1796,65,1861
3000,0.05,0.5,5,8,2992,2992,419,2573,1.0,1.0,0.14,4.49,1792,209,2001
3000,0.05,0.5,6,6,2994,2994,515,2479,1.0,1.0,0.17,4.93,1794,305,2099
3000,0.05,0.55,3,2,2998,2998,200,2798,1.0,1.0,0.07,3.21,1798,10,1808
3000,0.05,0.55,4,2,2998,2998,291,2707,1.0,1.0,0.1,3.78,1798,81,1879
3000,0.05,0.55,5,6,2994,2994,418,2576,1.0,1.0,0.14,4.34,1794,208,2002
3000,0.05,0.55,6,3,2997,2997,547,2450,1.0,1.0,0.18,4.99,1797,337,2134
3000,0.05,0.6,3,2,2998,2998,216,2782,1.0,1.0,0.07,3.16,1798,6,1804
3000,0.05,0.6,4,2,2998,2998,320,2678,1.0,1.0,0.11,3.79,1798,110,1908
3000,0.05,0.6,5,1,2999,2999,424,2575,1.0,1.0,0.14,4.43,1799,214,2013
3000,0.05,0.6,6,1,2999,2999,549,2450,1.0,1.0,0.18,4.88,1799,339,2138
3000,0.1,0.3,3,697,2303,2303,293,2010,0.77,0.77,0.1,3.1,1103,83,1186
3000,0.1,0.3,4,792,2208,2208,387,1821,0.74,0.74,0.13,3.71,1008,177,1185
3000,0.1,0.3,5,748,2252,2252,507,1745,0.75,0.75,0.17,4.25,1052,297,1349
3000,0.1,0.3,6,843,2157,2157,600,1557,0.72,0.72,0.2,4.88,957,390,1347
3000,0.1,0.35,3,259,2741,2741,322,2419,0.91,0.91,0.11,3.18,1541,112,1653
3000,0.1,0.35,4,242,2758,2758,505,2253,0.92,0.92,0.17,3.73,1558,295,1853
3000,0.1,0.35,5,226,2774,2774,659,2115,0.92,0.92,0.22,4.31,1574,449,2023
3000,0.1,0.35,6,232,2768,2768,813,1955,0.92,0.92,0.27,4.79,1568,603,2171
3000,0.1,0.4,3,84,2916,2916,326,2590,0.97,0.97,0.11,3.16,1716,116,1832
3000,0.1,0.4,4,86,2914,2914,517,2397,0.97,0.97,0.17,3.75,1714,307,2021
3000,0.1,0.4,5,69,2931,2931,673,2258,0.98,0.98,0.22,4.26,1731,463,2194
3000,0.1,0.4,6,102,2898,2898,869,2029,0.97,0.97,0.29,4.8,1698,659,2357
3000,0.1,0.45,3,81,2919,2919,307,2612,0.97,0.97,0.1,3.15,1719,97,1816
3000,0.1,0.45,4,78,2922,2922,554,2368,0.97,0.97,0.18,3.68,1722,344,2066
3000,0.1,0.45,5,86,2914,2914,693,2221,0.97,0.97,0.23,4.29,1714,483,2197
3000,0.1,0.45,6,94,2906,2906,857,2049,0.97,0.97,0.29,4.81,1706,647,2353
3000,0.1,0.5,3,26,2974,2974,391,2583,0.99,0.99,0.13,3.23,1774,181,1955
3000,0.1,0.5,4,37,2963,2963,543,2420,0.99,0.99,0.18,3.7,1763,333,2096
3000,0.1,0.5,5,36,2964,2964,679,2285,0.99,0.99,0.23,4.32,1764,469,2233
3000,0.1,0.5,6,41,2959,2959,872,2087,0.99,0.99,0.29,4.73,1759,662,2421
3000,0.1,0.55,3,14,2986,2986,366,2620,1.0,1.0,0.12,3.19,1786,156,1942
3000,0.1,0.55,4,9,2991,2991,510,2481,1.0,1.0,0.17,3.69,1791,300,2091
3000,0.1,0.55,5,17,2983,2983,753,2230,0.99,0.99,0.25,4.29,1783,543,2326
3000,0.1,0.55,6,12,2988,2988,852,2136,1.0,1.0,0.28,4.91,1788,642,2430
3000,0.1,0.6,3,5,2995,2995,367,2628,1.0,1.0,0.12,3.21,1795,157,1952
3000,0.1,0.6,4,3,2997,2997,523,2474,1.0,1.0,0.17,3.77,1797,313,2110
3000,0.1,0.6,5,3,2997,2997,698,2299,1.0,1.0,0.23,4.29,1797,488,2285
3000,0.1,0.6,6,4,2996,2996,833,2163,1.0,1.0,0.28,4.8,1796,623,2419
3000,0.15,0.3,3,1425,1575,1575,267,1308,0.53,0.53,0.09,3.17,375,57,432
3000,0.15,0.3,4,2985,15,15,3,12,0.01,0.01,0.0,3.33,1185,207,1392
3000,0.15,0.3,5,1340,1660,1660,473,1187,0.55,0.55,0.16,4.23,460,263,723
3000,0.15,0.3,6,1482,1518,1518,546,972,0.51,0.51,0.18,4.68,318,336,654
3000,0.15,0.35,3,2996,4,4,0,4,0.0,0.0,0.0,0,1196,210,1406
3000,0.15,0.35,4,1279,1721,1721,390,1331,0.57,0.57,0.13,3.61,521,180,701
3000,0.15,0.35,5,1280,1720,1720,547,1173,0.57,0.57,0.18,4.17,520,337,857
3000,0.15,0.35,6,1339,1661,1661,583,1078,0.55,0.55,0.19,4.66,461,373,834
3000,0.15,0.4,3,336,2664,2664,425,2239,0.89,0.89,0.14,3.1,1464,215,1679
3000,0.15,0.4,4,331,2669,2669,613,2056,0.89,0.89,0.2,3.66,1469,403,1872
3000,0.15,0.4,5,286,2714,2714,832,1882,0.9,0.9,0.28,4.2,1514,622,2136
3000,0.15,0.4,6,317,2683,2683,977,1706,0.89,0.89,0.33,4.68,1483,767,2250
3000,0.15,0.45,3,293,2707,2707,436,2271,0.9,0.9,0.15,3.13,1507,226,1733
3000,0.15,0.45,4,352,2648,2648,599,2049,0.88,0.88,0.2,3.66,1448,389,1837
3000,0.15,0.45,5,317,2683,2683,837,1846,0.89,0.89,0.28,4.2,1483,627,2110
3000,0.15,0.45,6,348,2652,2652,958,1694,0.88,0.88,0.32,4.67,1452,748,2200
3000,0.15,0.5,3,101,2899,2899,452,2447,0.97,0.97,0.15,3.06,1699,242,1941
3000,0.15,0.5,4,90,2910,2910,655,2255,0.97,0.97,0.22,3.72,1710,445,2155
3000,0.15,0.5,5,104,2896,2896,876,2020,0.97,0.97,0.29,4.14,1696,666,2362
3000,0.15,0.5,6,77,2923,2923,1100,1823,0.97,0.97,0.37,4.71,1723,890,2613
3000,0.15,0.55,3,29,2971,2971,551,2420,0.99,0.99,0.18,3.08,1771,341,2112
3000,0.15,0.55,4,42,2958,2958,663,2295,0.99,0.99,0.22,3.69,1758,453,2211
3000,0.15,0.55,5,36,2964,2964,876,2088,0.99,0.99,0.29,4.19,1764,666,2430
3000,0.15,0.55,6,37,2963,2963,1068,1895,0.99,0.99,0.36,4.69,1763,858,2621
3000,0.15,0.6,3,12,2988,2988,557,2431,1.0,1.0,0.19,3.15,1788,347,2135
3000,0.15,0.6,4,11,2989,2989,744,2245,1.0,1.0,0.25,3.7,1789,534,2323
3000,0.15,0.6,5,14,2986,2986,892,2094,1.0,1.0,0.3,4.15,1786,682,2468
3000,0.15,0.6,6,16,2984,2984,1117,1867,0.99,0.99,0.37,4.63,1784,907,2691
3000,0.2,0.3,3,2994,6,6,4,2,0.0,0.0,0.0,3.75,1194,206,1400
3000,0.2,0.3,4,2992,8,8,2,6,0.0,0.0,0.0,4.5,1192,208,1400
3000,0.2,0.3,5,2998,2,2,1,1,0.0,0.0,0.0,3.0,1198,209,1407
3000,0.2,0.3,6,2997,3,3,1,2,0.0,0.0,0.0,5.0,1197,209,1406
3000,0.2,0.35,3,746,2254,2254,428,1826,0.75,0.75,0.14,3.08,1054,218,1272
3000,0.2,0.35,4,818,2182,2182,581,1601,0.73,0.73,0.19,3.61,982,371,1353
3000,0.2,0.35,5,814,2186,2186,783,1403,0.73,0.73,0.26,4.07,986,573,1559
3000,0.2,0.35,6,777,2223,2223,945,1278,0.74,0.74,0.32,4.7,1023,735,1758
3000,0.2,0.4,3,839,2161,2161,415,1746,0.72,0.72,0.14,3.14,961,205,1166
3000,0.2,0.4,4,823,2177,2177,582,1595,0.73,0.73,0.19,3.63,977,372,1349
3000,0.2,0.4,5,869,2131,2131,760,1371,0.71,0.71,0.25,4.1,931,550,1481
3000,0.2,0.4,6,730,2270,2270,894,1376,0.76,0.76,0.3,4.59,1070,684,1754
3000,0.2,0.45,3,800,2200,2200,441,1759,0.73,0.73,0.15,3.05,1000,231,1231
3000,0.2,0.45,4,794,2206,2206,611,1595,0.74,0.74,0.2,3.51,1006,401,1407
3000,0.2,0.45,5,823,2177,2177,753,1424,0.73,0.73,0.25,4.03,977,543,1520
3000,0.2,0.45,6,759,2241,2241,928,1313,0.75,0.75,0.31,4.53,1041,718,1759
3000,0.2,0.5,3,127,2873,2873,598,2275,0.96,0.96,0.2,3.11,1673,388,2061
3000,0.2,0.5,4,164,2836,2836,842,1994,0.95,0.95,0.28,3.67,1636,632,2268
3000,0.2,0.5,5,164,2836,2836,1003,1833,0.95,0.95,0.33,4.02,1636,793,2429
3000,0.2,0.5,6,152,2848,2848,1201,1647,0.95,0.95,0.4,4.57,1648,991,2639
3000,0.2,0.55,3,168,2832,2832,576,2256,0.94,0.94,0.19,3.11,1632,366,1998
3000,0.2,0.55,4,171,2829,2829,817,2012,0.94,0.94,0.27,3.7,1629,607,2236
3000,0.2,0.55,5,150,2850,2850,978,1872,0.95,0.95,0.33,4.14,1650,768,2418
3000,0.2,0.55,6,187,2813,2813,1149,1664,0.94,0.94,0.38,4.63,1613,939,2552
3000,0.2,0.6,3,44,2956,2956,585,2371,0.99,0.99,0.2,3.05,1756,375,2131
3000,0.2,0.6,4,60,2940,2940,794,2146,0.98,0.98,0.26,3.65,1740,584,2324
3000,0.2,0.6,5,53,2947,2947,1073,1874,0.98,0.98,0.36,4.09,1747,863,2610
3000,0.2,0.6,6,45,2955,2955,1236,1719,0.98,0.98,0.41,4.63,1755,1026,2781
3000,0.25,0.3,3,2997,3,3,0,3,0.0,0.0,0.0,0,1197,210,1407
3000,0.25,0.3,4,2996,4,4,2,2,0.0,0.0,0.0,3.0,1196,208,1404
3000,0.25,0.3,5,2990,10,10,3,7,0.0,0.0,0.0,2.67,1190,207,1397
3000,0.25,0.3,6,2999,1,1,1,0,0.0,0.0,0.0,2.0,1199,209,1408
3000,0.25,0.35,3,2996,4,4,2,2,0.0,0.0,0.0,2.5,1196,208,1404
3000,0.25,0.35,4,2973,27,27,7,20,0.01,0.01,0.0,4.14,1173,203,1376
3000,0.25,0.35,5,2994,6,6,3,3,0.0,0.0,0.0,4.67,1194,207,1401
3000,0.25,0.35,6,2990,10,10,4,6,0.0,0.0,0.0,3.75,1190,206,1396
3000,0.25,0.4,3,524,2476,2476,560,1916,0.83,0.83,0.19,3.09,1276,350,1626
3000,0.25,0.4,4,508,2492,2492,781,1711,0.83,0.83,0.26,3.57,1292,571,1863
3000,0.25,0.4,5,523,2477,2477,976,1501,0.83,0.83,0.33,4.03,1277,766,2043
3000,0.25,0.4,6,515,2485,2485,1122,1363,0.83,0.83,0.37,4.49,1285,912,2197
3000,0.25,0.45,3,470,2530,2530,576,1954,0.84,0.84,0.19,3.04,1330,366,1696
3000,0.25,0.45,4,500,2500,2500,757,1743,0.83,0.83,0.25,3.56,1300,547,1847
3000,0.25,0.45,5,505,2495,2495,948,1547,0.83,0.83,0.32,4.01,1295,738,2033
3000,0.25,0.45,6,547,2453,2453,1084,1369,0.82,0.82,0.36,4.51,1253,874,2127
3000,0.25,0.5,3,502,2498,2498,563,1935,0.83,0.83,0.19,3.08,1298,353,1651
3000,0.25,0.5,4,519,2481,2481,782,1699,0.83,0.83,0.26,3.6,1281,572,1853
3000,0.25,0.5,5,494,2506,2506,994,1512,0.84,0.84,0.33,4.01,1306,784,2090
3000,0.25,0.5,6,533,2467,2467,1118,1349,0.82,0.82,0.37,4.59,1267,908,2175
3000,0.25,0.55,3,102,2898,2898,654,2244,0.97,0.97,0.22,3.07,1698,444,2142
3000,0.25,0.55,4,113,2887,2887,884,2003,0.96,0.96,0.29,3.57,1687,674,2361
3000,0.25,0.55,5,101,2899,2899,1140,1759,0.97,0.97,0.38,4.03,1699,930,2629
3000,0.25,0.55,6,93,2907,2907,1325,1582,0.97,0.97,0.44,4.6,1707,1115,2822
3000,0.25,0.6,3,91,2909,2909,672,2237,0.97,0.97,0.22,3.06,1709,462,2171
3000,0.25,0.6,4,100,2900,2900,935,1965,0.97,0.97,0.31,3.6,1700,725,2425
3000,0.25,0.6,5,109,2891,2891,1063,1828,0.96,0.96,0.35,4.08,1691,853,2544
3000,0.25,0.6,6,89,2911,2911,1342,1569,0.97,0.97,0.45,4.58,1711,1132,2843
3000,0.3,0.3,3,2726,274,274,76,198,0.09,0.09,0.03,3.01,926,134,1060
3000,0.3,0.3,4,2996,4,4,2,2,0.0,0.0,0.0,4.0,1196,208,1404
3000,0.3,0.3,5,2994,6,6,1,5,0.0,0.0,0.0,5.0,1194,209,1403
3000,0.3,0.3,6,2650,350,350,178,172,0.12,0.12,0.06,4.39,850,32,882
3000,0.3,0.35,3,2983,17,17,6,11,0.01,0.01,0.0,3.17,1183,204,1387
3000,0.3,0.35,4,2976,24,24,6,18,0.01,0.01,0.0,4.17,1176,204,1380
3000,0.3,0.35,5,2998,2,2,1,1,0.0,0.0,0.0,3.0,1198,209,1407
3000,0.3,0.35,6,2997,3,3,1,2,0.0,0.0,0.0,5.0,1197,209,1406
3000,0.3,0.4,3,2951,49,49,14,35,0.02,0.02,0.0,3.07,1151,196,1347
3000,0.3,0.4,4,2987,13,13,5,8,0.0,0.0,0.0,3.2,1187,205,1392
3000,0.3,0.4,5,2999,1,1,1,0,0.0,0.0,0.0,5.0,1199,209,1408
3000,0.3,0.4,6,2997,3,3,2,1,0.0,0.0,0.0,3.5,1197,208,1405
3000,0.3,0.45,3,2983,17,17,5,12,0.01,0.01,0.0,3.0,1183,205,1388
3000,0.3,0.45,4,2983,17,17,5,12,0.01,0.01,0.0,3.0,1183,205,1388
3000,0.3,0.45,5,2998,2,2,2,0,0.0,0.0,0.0,4.5,1198,208,1406
3000,0.3,0.45,6,2995,5,5,4,1,0.0,0.0,0.0,5.0,1195,206,1401
3000,0.3,0.5,3,376,2624,2624,654,1970,0.87,0.87,0.22,3.05,1424,444,1868
3000,0.3,0.5,4,336,2664,2664,911,1753,0.89,0.89,0.3,3.53,1464,701,2165
3000,0.3,0.5,5,355,2645,2645,1119,1526,0.88,0.88,0.37,3.99,1445,909,2354
3000,0.3,0.5,6,356,2644,2644,1278,1366,0.88,0.88,0.43,4.41,1444,1068,2512
3000,0.3,0.55,3,389,2611,2611,686,1925,0.87,0.87,0.23,3.06,1411,476,1887
3000,0.3,0.55,4,366,2634,2634,862,1772,0.88,0.88,0.29,3.55,1434,652,2086
3000,0.3,0.55,5,296,2704,2704,1117,1587,0.9,0.9,0.37,4.07,1504,907,2411
3000,0.3,0.55,6,356,2644,2644,1302,1342,0.88,0.88,0.43,4.38,1444,1092,2536
3000,0.3,0.6,3,68,2932,2932,772,2160,0.98,0.98,0.26,3.08,1732,562,2294
3000,0.3,0.6,4,69,2931,2931,980,1951,0.98,0.98,0.33,3.53,1731,770,2501
3000,0.3,0.6,5,70,2930,2930,1211,1719,0.98,0.98,0.4,3.98,1730,1001,2731
3000,0.3,0.6,6,62,2938,2938,1460,1478,0.98,0.98,0.49,4.44,1738,1250,2988
3000,0.35,0.3,3,2994,6,6,1,5,0.0,0.0,0.0,3.0,1194,209,1403
3000,0.35,0.3,4,2997,3,3,0,3,0.0,0.0,0.0,0,1197,210,1407
3000,0.35,0.3,5,2992,8,8,4,4,0.0,0.0,0.0,2.75,1192,206,1398
3000,0.35,0.3,6,2999,1,1,0,1,0.0,0.0,0.0,0,1199,210,1409
3000,0.35,0.35,3,2999,1,1,1,0,0.0,0.0,0.0,4.0,1199,209,1408
3000,0.35,0.35,4,2999,1,1,1,0,0.0,0.0,0.0,5.0,1199,209,1408
3000,0.35,0.35,5,2996,4,4,1,3,0.0,0.0,0.0,6.0,1196,209,1405
3000,0.35,0.35,6,2385,615,615,310,305,0.2,0.2,0.1,4.37,585,100,685
3000,0.35,0.4,3,2994,6,6,1,5,0.0,0.0,0.0,4.0,1194,209,1403
3000,0.35,0.4,4,2997,3,3,1,2,0.0,0.0,0.0,5.0,1197,209,1406
3000,0.35,0.4,5,2967,33,33,14,19,0.01,0.01,0.0,3.79,1167,196,1363
3000,0.35,0.4,6,2216,784,784,406,378,0.26,0.26,0.14,4.31,416,196,612
3000,0.35,0.45,3,2992,8,8,4,4,0.0,0.0,0.0,2.75,1192,206,1398
3000,0.35,0.45,4,2992,8,8,4,4,0.0,0.0,0.0,3.0,1192,206,1398
3000,0.35,0.45,5,2998,2,2,1,1,0.0,0.0,0.0,2.0,1198,209,1407
3000,0.35,0.45,6,2994,6,6,3,3,0.0,0.0,0.0,5.33,1194,207,1401
3000,0.35,0.5,3,2999,1,1,0,1,0.0,0.0,0.0,0,1199,210,1409
3000,0.35,0.5,4,2999,1,1,0,1,0.0,0.0,0.0,0,1199,210,1409
3000,0.35,0.5,5,2364,636,636,298,338,0.21,0.21,0.1,3.95,564,88,652
3000,0.35,0.5,6,2998,2,2,0,2,0.0,0.0,0.0,0,1198,210,1408
3000,0.35,0.55,3,250,2750,2750,757,1993,0.92,0.92,0.25,3.03,1550,547,2097
3000,0.35,0.55,4,247,2753,2753,1035,1718,0.92,0.92,0.34,3.46,1553,825,2378
3000,0.35,0.55,5,263,2737,2737,1202,1535,0.91,0.91,0.4,3.93,1537,992,2529
3000,0.35,0.55,6,263,2737,2737,1392,1345,0.91,0.91,0.46,4.28,1537,1182,2719
3000,0.35,0.6,3,255,2745,2745,772,1973,0.92,0.92,0.26,3.09,1545,562,2107
3000,0.35,0.6,4,245,2755,2755,1000,1755,0.92,0.92,0.33,3.53,1555,790,2345
3000,0.35,0.6,5,244,2756,2756,1196,1560,0.92,0.92,0.4,3.93,1556,986,2542
3000,0.35,0.6,6,266,2734,2734,1431,1303,0.91,0.91,0.48,4.4,1534,1221,2755
3000,0.4,0.3,3,2999,1,1,1,0,0.0,0.0,0.0,4.0,1199,209,1408
3000,0.4,0.3,4,2999,1,1,1,0,0.0,0.0,0.0,5.0,1199,209,1408
3000,0.4,0.3,5,2999,1,1,1,0,0.0,0.0,0.0,2.0,1199,209,1408
3000,0.4,0.3,6,2999,1,1,0,1,0.0,0.0,0.0,0,1199,210,1409
3000,0.4,0.35,3,2992,8,8,3,5,0.0,0.0,0.0,2.67,1192,207,1399
3000,0.4,0.35,4,2990,10,10,3,7,0.0,0.0,0.0,3.0,1190,207,1397
3000,0.4,0.35,5,2994,6,6,2,4,0.0,0.0,0.0,4.0,1194,208,1402
3000,0.4,0.35,6,2992,8,8,3,5,0.0,0.0,0.0,3.67,1192,207,1399
3000,0.4,0.4,3,1821,1179,1179,365,814,0.39,0.39,0.12,3.03,21,155,176
3000,0.4,0.4,4,2985,15,15,5,10,0.01,0.01,0.0,3.8,1185,205,1390
3000,0.4,0.4,5,2981,19,19,12,7,0.01,0.01,0.0,3.67,1181,198,1379
3000,0.4,0.4,6,1968,1032,1032,547,485,0.34,0.34,0.18,4.22,168,337,505
3000,0.4,0.45,3,1818,1182,1182,328,854,0.39,0.39,0.11,3.01,18,118,136
3000,0.4,0.45,4,2996,4,4,0,4,0.0,0.0,0.0,0,1196,210,1406
3000,0.4,0.45,5,1758,1242,1242,540,702,0.41,0.41,0.18,3.95,42,330,372
3000,0.4,0.45,6,2990,10,10,5,5,0.0,0.0,0.0,4.2,1190,205,1395
3000,0.4,0.5,3,1915,1085,1085,317,768,0.36,0.36,0.11,3.1,115,107,222
3000,0.4,0.5,4,2996,4,4,1,3,0.0,0.0,0.0,3.0,1196,209,1405
3000,0.4,0.5,5,1938,1062,1062,508,554,0.35,0.35,0.17,3.85,138,298,436
3000,0.4,0.5,6,1945,1055,1055,548,507,0.35,0.35,0.18,4.34,145,338,483
3000,0.4,0.55,3,2994,6,6,1,5,0.0,0.0,0.0,4.0,1194,209,1403
3000,0.4,0.55,4,2997,3,3,1,2,0.0,0.0,0.0,5.0,1197,209,1406
3000,0.4,0.55,5,1804,1196,1196,548,648,0.4,0.4,0.18,3.96,4,338,342
3000,0.4,0.55,6,2981,19,19,13,6,0.01,0.01,0.0,3.85,1181,197,1378
3000,0.4,0.6,3,178,2822,2822,817,2005,0.94,0.94,0.27,3.01,1622,607,2229
3000,0.4,0.6,4,197,2803,2803,1065,1738,0.93,0.93,0.35,3.46,1603,855,2458
3000,0.4,0.6,5,159,2841,2841,1349,1492,0.95,0.95,0.45,3.87,1641,1139,2780
3000,0.4,0.6,6,205,2795,2795,1485,1310,0.93,0.93,0.49,4.33,1595,1275,2870
3000,0.45,0.3,3,2999,1,1,0,1,0.0,0.0,0.0,0,1199,210,1409
3000,0.45,0.3,4,2999,1,1,1,0,0.0,0.0,0.0,4.0,1199,209,1408
3000,0.45,0.3,5,2999,1,1,1,0,0.0,0.0,0.0,5.0,1199,209,1408
3000,0.45,0.3,6,2999,1,1,1,0,0.0,0.0,0.0,2.0,1199,209,1408
3000,0.45,0.35,3,2999,1,1,0,1,0.0,0.0,0.0,0,1199,210,1409
3000,0.45,0.35,4,2999,1,1,0,1,0.0,0.0,0.0,0,1199,210,1409
3000,0.45,0.35,5,2999,1,1,1,0,0.0,0.0,0.0,4.0,1199,209,1408
3000,0.45,0.35,6,2999,1,1,1,0,0.0,0.0,0.0,2.0,1199,209,1408
3000,0.45,0.4,3,2995,5,5,1,4,0.0,0.0,0.0,3.0,1195,209,1404
3000,0.45,0.4,4,1394,1606,1606,652,954,0.54,0.54,0.22,3.44,406,442,848
3000,0.45,0.4,5,1506,1494,1494,699,795,0.5,0.5,0.23,3.89,294,489,783
3000,0.45,0.4,6,2998,2,2,1,1,0.0,0.0,0.0,4.0,1198,209,1407
3000,0.45,0.45,3,1404,1596,1596,463,1133,0.53,0.53,0.15,3.06,396,253,649
3000,0.45,0.45,4,2998,2,2,1,1,0.0,0.0,0.0,2.0,1198,209,1407
3000,0.45,0.45,5,1677,1323,1323,618,705,0.44,0.44,0.21,3.88,123,408,531
3000,0.45,0.45,6,1554,1446,1446,724,722,0.48,0.48,0.24,4.31,246,514,760
3000,0.45,0.5,3,1583,1417,1417,427,990,0.47,0.47,0.14,3.02,217,217,434
3000,0.45,0.5,4,1487,1513,1513,608,905,0.5,0.5,0.2,3.44,313,398,711
3000,0.45,0.5,5,2994,6,6,4,2,0.0,0.0,0.0,4.25,1194,206,1400
3000,0.45,0.5,6,1485,1515,1515,802,713,0.51,0.51,0.27,4.29,315,592,907
3000,0.45,0.55,3,1546,1454,1454,443,1011,0.48,0.48,0.15,3.01,254,233,487
3000,0.45,0.55,4,2999,1,1,1,0,0.0,0.0,0.0,5.0,1199,209,1408
3000,0.45,0.55,5,2994,6,6,4,2,0.0,0.0,0.0,4.25,1194,206,1400
3000,0.45,0.55,6,1485,1515,1515,802,713,0.51,0.51,0.27,4.29,315,592,907
3000,0.45,0.6,3,148,2852,2852,861,1991,0.95,0.95,0.29,3.02,1652,651,2303
3000,0.45,0.6,4,162,2838,2838,1110,1728,0.95,0.95,0.37,3.41,1638,900,2538
3000,0.45,0.6,5,134,2866,2866,1347,1519,0.96,0.96,0.45,3.88,1666,1137,2803
3000,0.45,0.6,6,134,2866,2866,1515,1351,0.96,0.96,0.51,4.25,1666,1305,2971
3000,0.5,0.3,3,2999,1,1,0,1,0.0,0.0,0.0,0,1199,210,1409
3000,0.5,0.3,4,2999,1,1,0,1,0.0,0.0,0.0,0,1199,210,1409
3000,0.5,0.3,5,2999,1,1,1,0,0.0,0.0,0.0,2.0,1199,209,1408
3000,0.5,0.3,6,2999,1,1,1,0,0.0,0.0,0.0,2.0,1199,209,1408
3000,0.5,0.35,3,2999,1,1,0,1,0.0,0.0,0.0,0,1199,210,1409
3000,0.5,0.35,4,2999,1,1,0,1,0.0,0.0,0.0,0,1199,210,1409
3000,0.5,0.35,5,2999,1,1,0,1,0.0,0.0,0.0,0,1199,210,1409
3000,0.5,0.35,6,2999,1,1,1,0,0.0,0.0,0.0,4.0,1199,209,1408
3000,0.5,0.4,3,1335,1665,1665,522,1143,0.56,0.56,0.17,3.03,465,312,777
3000,0.5,0.4,4,1193,1807,1807,759,1048,0.6,0.6,0.25,3.45,607,549,1156
3000,0.5,0.4,5,1255,1745,1745,836,909,0.58,0.58,0.28,3.8,545,626,1171
3000,0.5,0.4,6,2993,7,7,6,1,0.0,0.0,0.0,4.0,1193,204,1397
3000,0.5,0.45,3,1233,1767,1767,549,1218,0.59,0.59,0.18,2.97,567,339,906
3000,0.5,0.45,4,1222,1778,1778,723,1055,0.59,0.59,0.24,3.41,578,513,1091
3000,0.5,0.45,5,1171,1829,1829,860,969,0.61,0.61,0.29,3.88,629,650,1279
3000,0.5,0.45,6,1233,1767,1767,1000,767,0.59,0.59,0.33,4.2,567,790,1357
3000,0.5,0.5,3,1176,1824,1824,567,1257,0.61,0.61,0.19,2.94,624,357,981
3000,0.5,0.5,4,1143,1857,1857,754,1103,0.62,0.62,0.25,3.37,657,544,1201
3000,0.5,0.5,5,1159,1841,1841,879,962,0.61,0.61,0.29,3.84,641,669,1310
3000,0.5,0.5,6,1205,1795,1795,983,812,0.6,0.6,0.33,4.14,595,773,1368
3000,0.5,0.55,3,1268,1732,1732,542,1190,0.58,0.58,0.18,3.01,532,332,864
3000,0.5,0.55,4,1236,1764,1764,684,1080,0.59,0.59,0.23,3.38,564,474,1038
3000,0.5,0.55,5,1183,1817,1817,879,938,0.61,0.61,0.29,3.86,617,669,1286
3000,0.5,0.55,6,1119,1881,1881,1001,880,0.63,0.63,0.33,4.17,681,791,1472
3000,0.5,0.6,3,1253,1747,1747,540,1207,0.58,0.58,0.18,2.98,547,330,877
3000,0.5,0.6,4,2994,6,6,0,6,0.0,0.0,0.0,0,1194,210,1404
3000,0.5,0.6,5,1268,1732,1732,829,903,0.58,0.58,0.28,3.9,532,619,1151
3000,0.5,0.6,6,1261,1739,1739,930,809,0.58,0.58,0.31,4.27,539,720,1259
3000,0.55,0.3,3,2999,1,1,1,0,0.0,0.0,0.0,2.0,1199,209,1408
3000,0.55,0.3,4,2999,1,1,0,1,0.0,0.0,0.0,0,1199,210,1409
3000,0.55,0.3,5,2999,1,1,1,0,0.0,0.0,0.0,3.0,1199,209,1408
3000,0.55,0.3,6,2999,1,1,1,0,0.0,0.0,0.0,6.0,1199,209,1408
3000,0.55,0.35,3,2999,1,1,0,1,0.0,0.0,0.0,0,1199,210,1409
3000,0.55,0.35,4,2999,1,1,0,1,0.0,0.0,0.0,0,1199,210,1409
3000,0.55,0.35,5,2999,1,1,1,0,0.0,0.0,0.0,5.0,1199,209,1408
3000,0.55,0.35,6,2999,1,1,1,0,0.0,0.0,0.0,5.0,1199,209,1408
3000,0.55,0.4,3,2999,1,1,0,1,0.0,0.0,0.0,0,1199,210,1409
3000,0.55,0.4,4,2999,1,1,1,0,0.0,0.0,0.0,2.0,1199,209,1408
3000,0.55,0.4,5,2999,1,1,1,0,0.0,0.0,0.0,4.0,1199,209,1408
3000,0.55,0.4,6,2999,1,1,0,1,0.0,0.0,0.0,0,1199,210,1409
3000,0.55,0.45,3,1122,1878,1878,616,1262,0.63,0.63,0.21,2.92,678,406,1084
3000,0.55,0.45,4,1016,1984,1984,830,1154,0.66,0.66,0.28,3.46,784,620,1404
3000,0.55,0.45,5,1062,1938,1938,923,1015,0.65,0.65,0.31,3.7,738,713,1451
3000,0.55,0.45,6,1009,1991,1991,1123,868,0.66,0.66,0.37,4.2,791,913,1704
3000,0.55,0.5,3,1047,1953,1953,613,1340,0.65,0.65,0.2,2.94,753,403,1156
3000,0.55,0.5,4,1003,1997,1997,842,1155,0.67,0.67,0.28,3.41,797,632,1429
3000,0.55,0.5,5,1074,1926,1926,954,972,0.64,0.64,0.32,3.8,726,744,1470
3000,0.55,0.5,6,1039,1961,1961,1079,882,0.65,0.65,0.36,4.18,761,869,1630
3000,0.55,0.55,3,2984,16,16,8,8,0.01,0.01,0.0,3.25,1184,202,1386
3000,0.55,0.55,4,2984,16,16,11,5,0.01,0.01,0.0,3.82,1184,199,1383
3000,0.55,0.55,5,1018,1982,1982,1053,929,0.66,0.66,0.35,3.82,782,843,1625
3000,0.55,0.55,6,2984,16,16,11,5,0.01,0.01,0.0,3.73,1184,199,1383
3000,0.55,0.6,3,1034,1966,1966,641,1325,0.66,0.66,0.21,2.98,766,431,1197
3000,0.55,0.6,4,1059,1941,1941,795,1146,0.65,0.65,0.27,3.45,741,585,1326
3000,0.55,0.6,5,1069,1931,1931,949,982,0.64,0.64,0.32,3.84,731,739,1470
3000,0.55,0.6,6,1003,1997,1997,1055,942,0.67,0.67,0.35,4.12,797,845,1642
3000,0.6,0.3,3,2999,1,1,1,0,0.0,0.0,0.0,3.0,1199,209,1408
3000,0.6,0.3,4,2999,1,1,1,0,0.0,0.0,0.0,5.0,1199,209,1408
3000,0.6,0.3,5,2999,1,1,1,0,0.0,0.0,0.0,5.0,1199,209,1408
3000,0.6,0.3,6,2999,1,1,0,1,0.0,0.0,0.0,0,1199,210,1409
3000,0.6,0.35,3,2999,1,1,1,0,0.0,0.0,0.0,2.0,1199,209,1408
3000,0.6,0.35,4,2999,1,1,1,0,0.0,0.0,0.0,4.0,1199,209,1408
3000,0.6,0.35,5,2999,1,1,0,1,0.0,0.0,0.0,0,1199,210,1409
3000,0.6,0.35,6,2999,1,1,1,0,0.0,0.0,0.0,2.0,1199,209,1408
3000,0.6,0.4,3,2999,1,1,1,0,0.0,0.0,0.0,2.0,1199,209,1408
3000,0.6,0.4,4,2999,1,1,1,0,0.0,0.0,0.0,5.0,1199,209,1408
3000,0.6,0.4,5,2999,1,1,0,1,0.0,0.0,0.0,0,1199,210,1409
3000,0.6,0.4,6,2999,1,1,1,0,0.0,0.0,0.0,5.0,1199,209,1408
3000,0.6,0.45,3,2999,1,1,0,1,0.0,0.0,0.0,0,1199,210,1409
3000,0.6,0.45,4,2999,1,1,0,1,0.0,0.0,0.0,0,1199,210,1409
3000,0.6,0.45,5,2999,1,1,1,0,0.0,0.0,0.0,2.0,1199,209,1408
3000,0.6,0.45,6,2999,1,1,1,0,0.0,0.0,0.0,4.0,1199,209,1408
3000,0.6,0.5,3,865,2135,2135,718,1417,0.71,0.71,0.24,2.95,935,508,1443
3000,0.6,0.5,4,874,2126,2126,884,1242,0.71,0.71,0.29,3.42,926,674,1600
3000,0.6,0.5,5,880,2120,2120,1052,1068,0.71,0.71,0.35,3.83,920,842,1762
3000,0.6,0.5,6,842,2158,2158,1186,972,0.72,0.72,0.4,4.19,958,976,1934
3000,0.6,0.55,3,932,2068,2068,645,1423,0.69,0.69,0.21,2.96,868,435,1303
3000,0.6,0.55,4,852,2148,2148,890,1258,0.72,0.72,0.3,3.39,948,680,1628
3000,0.6,0.55,5,888,2112,2112,1075,1037,0.7,0.7,0.36,3.79,912,865,1777
3000,0.6,0.55,6,858,2142,2142,1194,948,0.71,0.71,0.4,4.18,942,984,1926
3000,0.6,0.6,3,2999,1,1,1,0,0.0,0.0,0.0,2.0,1199,209,1408
3000,0.6,0.6,4,865,2135,2135,867,1268,0.71,0.71,0.29,3.35,935,657,1592
3000,0.6,0.6,5,865,2135,2135,1032,1103,0.71,0.71,0.34,3.74,935,822,1757
3000,0.6,0.6,6,896,2104,2104,1169,935,0.7,0.7,0.39,4.17,904,959,1863
3000,0.65,0.3,3,2999,1,1,0,1,0.0,0.0,0.0,0,1199,210,1409
3000,0.65,0.3,4,2999,1,1,0,1,0.0,0.0,0.0,0,1199,210,1409
3000,0.65,0.3,5,2999,1,1,1,0,0.0,0.0,0.0,2.0,1199,209,1408
3000,0.65,0.3,6,2999,1,1,1,0,0.0,0.0,0.0,4.0,1199,209,1408
3000,0.65,0.35,3,2999,1,1,0,1,0.0,0.0,0.0,0,1199,210,1409
3000,0.65,0.35,4,2999,1,1,1,0,0.0,0.0,0.0,3.0,1199,209,1408
3000,0.65,0.35,5,2999,1,1,0,1,0.0,0.0,0.0,0,1199,210,1409
3000,0.65,0.35,6,2999,1,1,1,0,0.0,0.0,0.0,3.0,1199,209,1408
3000,0.65,0.4,3,2999,1,1,0,1,0.0,0.0,0.0,0,1199,210,1409
3000,0.65,0.4,4,2999,1,1,1,0,0.0,0.0,0.0,4.0,1199,209,1408
3000,0.65,0.4,5,2999,1,1,1,0,0.0,0.0,0.0,5.0,1199,209,1408
3000,0.65,0.4,6,2999,1,1,1,0,0.0,0.0,0.0,4.0,1199,209,1408
3000,0.65,0.45,3,2999,1,1,0,1,0.0,0.0,0.0,0,1199,210,1409
3000,0.65,0.45,4,2999,1,1,0,1,0.0,0.0,0.0,0,1199,210,1409
3000,0.65,0.45,5,2999,1,1,1,0,0.0,0.0,0.0,4.0,1199,209,1408
3000,0.65,0.45,6,2999,1,1,1,0,0.0,0.0,0.0,3.0,1199,209,1408
3000,0.65,0.5,3,808,2192,2192,808,1384,0.73,0.73,0.27,2.97,992,598,1590
3000,0.65,0.5,4,766,2234,2234,946,1288,0.74,0.74,0.32,3.4,1034,736,1770
3000,0.65,0.5,5,747,2253,2253,1112,1141,0.75,0.75,0.37,3.69,1053,902,1955
3000,0.65,0.5,6,814,2186,2186,1213,973,0.73,0.73,0.4,4.12,986,1003,1989
3000,0.65,0.55,3,749,2251,2251,752,1499,0.75,0.75,0.25,2.95,1051,542,1593
3000,0.65,0.55,4,761,2239,2239,995,1244,0.75,0.75,0.33,3.37,1039,785,1824
3000,0.65,0.55,5,778,2222,2222,1130,1092,0.74,0.74,0.38,3.76,1022,920,1942
3000,0.65,0.55,6,784,2216,2216,1264,952,0.74,0.74,0.42,4.11,1016,1054,2070
3000,0.65,0.6,3,847,2153,2153,762,1391,0.72,0.72,0.25,2.98,953,552,1505
3000,0.65,0.6,4,802,2198,2198,930,1268,0.73,0.73,0.31,3.32,998,720,1718
3000,0.65,0.6,5,2999,1,1,1,0,0.0,0.0,0.0,2.0,1199,209,1408
3000,0.65,0.6,6,749,2251,2251,1270,981,0.75,0.75,0.42,4.13,1051,1060,2111
3000,0.7,0.3,3,2999,1,1,0,1,0.0,0.0,0.0,0,1199,210,1409
3000,0.7,0.3,4,2999,1,1,0,1,0.0,0.0,0.0,0,1199,210,1409
3000,0.7,0.3,5,2999,1,1,1,0,0.0,0.0,0.0,4.0,1199,209,1408
3000,0.7,0.3,6,2999,1,1,1,0,0.0,0.0,0.0,2.0,1199,209,1408
3000,0.7,0.35,3,2999,1,1,0,1,0.0,0.0,0.0,0,1199,210,1409
3000,0.7,0.35,4,2999,1,1,0,1,0.0,0.0,0.0,0,1199,210,1409
3000,0.7,0.35,5,2999,1,1,1,0,0.0,0.0,0.0,4.0,1199,209,1408
3000,0.7,0.35,6,2999,1,1,0,1,0.0,0.0,0.0,0,1199,210,1409
3000,0.7,0.4,3,2999,1,1,0,1,0.0,0.0,0.0,0,1199,210,1409
3000,0.7,0.4,4,2999,1,1,1,0,0.0,0.0,0.0,5.0,1199,209,1408
3000,0.7,0.4,5,2999,1,1,1,0,0.0,0.0,0.0,5.0,1199,209,1408
3000,0.7,0.4,6,2999,1,1,0,1,0.0,0.0,0.0,0,1199,210,1409
3000,0.7,0.45,3,2999,1,1,1,0,0.0,0.0,0.0,2.0,1199,209,1408
3000,0.7,0.45,4,2999,1,1,1,0,0.0,0.0,0.0,4.0,1199,209,1408
3000,0.7,0.45,5,2999,1,1,0,1,0.0,0.0,0.0,0,1199,210,1409
3000,0.7,0.45,6,2999,1,1,1,0,0.0,0.0,0.0,2.0,1199,209,1408
3000,0.7,0.5,3,2999,1,1,1,0,0.0,0.0,0.0,2.0,1199,209,1408
3000,0.7,0.5,4,2999,1,1,1,0,0.0,0.0,0.0,5.0,1199,209,1408
3000,0.7,0.5,5,2999,1,1,0,1,0.0,0.0,0.0,0,1199,210,1409
3000,0.7,0.5,6,2999,1,1,1,0,0.0,0.0,0.0,5.0,1199,209,1408
3000,0.7,0.55,3,602,2398,2398,826,1572,0.8,0.8,0.28,2.95,1198,616,1814
3000,0.7,0.55,4,655,2345,2345,1018,1327,0.78,0.78,0.34,3.28,1145,808,1953
3000,0.7,0.55,5,728,2272,2272,1142,1130,0.76,0.76,0.38,3.72,1072,932,2004
3000,0.7,0.55,6,715,2285,2285,1311,974,0.76,0.76,0.44,4.11,1085,1101,2186
3000,0.7,0.6,3,645,2355,2355,803,1552,0.79,0.79,0.27,2.95,1155,593,1748
3000,0.7,0.6,4,724,2276,2276,995,1281,0.76,0.76,0.33,3.32,1076,785,1861
3000,0.7,0.6,5,666,2334,2334,1161,1173,0.78,0.78,0.39,3.78,1134,951,2085
3000,0.7,0.6,6,681,2319,2319,1312,1007,0.77,0.77,0.44,4.12,1119,1102,2221
3000,0.75,0.3,3,2999,1,1,0,1,0.0,0.0,0.0,0,1199,210,1409
3000,0.75,0.3,4,2999,1,1,1,0,0.0,0.0,0.0,4.0,1199,209,1408
3000,0.75,0.3,5,2999,1,1,1,0,0.0,0.0,0.0,3.0,1199,209,1408
3000,0.75,0.3,6,2999,1,1,0,1,0.0,0.0,0.0,0,1199,210,1409
3000,0.75,0.35,3,2999,1,1,1,0,0.0,0.0,0.0,4.0,1199,209,1408
3000,0.75,0.35,4,2999,1,1,0,1,0.0,0.0,0.0,0,1199,210,1409
3000,0.75,0.35,5,2999,1,1,1,0,0.0,0.0,0.0,4.0,1199,209,1408
3000,0.75,0.35,6,2999,1,1,1,0,0.0,0.0,0.0,7.0,1199,209,1408
3000,0.75,0.4,3,2999,1,1,1,0,0.0,0.0,0.0,2.0,1199,209,1408
3000,0.75,0.4,4,2999,1,1,1,0,0.0,0.0,0.0,4.0,1199,209,1408
3000,0.75,0.4,5,2999,1,1,1,0,0.0,0.0,0.0,5.0,1199,209,1408
3000,0.75,0.4,6,2999,1,1,1,0,0.0,0.0,0.0,2.0,1199,209,1408
3000,0.75,0.45,3,2999,1,1,0,1,0.0,0.0,0.0,0,1199,210,1409
3000,0.75,0.45,4,2999,1,1,0,1,0.0,0.0,0.0,0,1199,210,1409
3000,0.75,0.45,5,2999,1,1,1,0,0.0,0.0,0.0,4.0,1199,209,1408
3000,0.75,0.45,6,2999,1,1,1,0,0.0,0.0,0.0,2.0,1199,209,1408
3000,0.75,0.5,3,2999,1,1,0,1,0.0,0.0,0.0,0,1199,210,1409
3000,0.75,0.5,4,2999,1,1,0,1,0.0,0.0,0.0,0,1199,210,1409
3000,0.75,0.5,5,2999,1,1,1,0,0.0,0.0,0.0,4.0,1199,209,1408
3000,0.75,0.5,6,2999,1,1,0,1,0.0,0.0,0.0,0,1199,210,1409
3000,0.75,0.55,3,613,2387,2387,861,1526,0.8,0.8,0.29,2.91,1187,651,1838
3000,0.75,0.55,4,587,2413,2413,1080,1333,0.8,0.8,0.36,3.34,1213,870,2083
3000,0.75,0.55,5,2995,5,5,2,3,0.0,0.0,0.0,3.0,1195,208,1403
3000,0.75,0.55,6,583,2417,2417,1374,1043,0.81,0.81,0.46,3.97,1217,1164,2381
3000,0.75,0.6,3,565,2435,2435,851,1584,0.81,0.81,0.28,2.92,1235,641,1876
3000,0.75,0.6,4,629,2371,2371,1042,1329,0.79,0.79,0.35,3.3,1171,832,2003
3000,0.75,0.6,5,595,2405,2405,1203,1202,0.8,0.8,0.4,3.81,1205,993,2198
3000,0.75,0.6,6,647,2353,2353,1356,997,0.78,0.78,0.45,4.06,1153,1146,2299
3000,0.8,0.3,3,2999,1,1,0,1,0.0,0.0,0.0,0,1199,210,1409
3000,0.8,0.3,4,2999,1,1,1,0,0.0,0.0,0.0,2.0,1199,209,1408
3000,0.8,0.3,5,2999,1,1,1,0,0.0,0.0,0.0,5.0,1199,209,1408
3000,0.8,0.3,6,2999,1,1,0,1,0.0,0.0,0.0,0,1199,210,1409
3000,0.8,0.35,3,2999,1,1,0,1,0.0,0.0,0.0,0,1199,210,1409
3000,0.8,0.35,4,2999,1,1,1,0,0.0,0.0,0.0,2.0,1199,209,1408
3000,0.8,0.35,5,2999,1,1,0,1,0.0,0.0,0.0,0,1199,210,1409
3000,0.8,0.35,6,2999,1,1,1,0,0.0,0.0,0.0,3.0,1199,209,1408
3000,0.8,0.4,3,2999,1,1,1,0,0.0,0.0,0.0,4.0,1199,209,1408
3000,0.8,0.4,4,2999,1,1,1,0,0.0,0.0,0.0,2.0,1199,209,1408
3000,0.8,0.4,5,2999,1,1,1,0,0.0,0.0,0.0,2.0,1199,209,1408
3000,0.8,0.4,6,2999,1,1,0,1,0.0,0.0,0.0,0,1199,210,1409
3000,0.8,0.45,3,2999,1,1,1,0,0.0,0.0,0.0,3.0,1199,209,1408
3000,0.8,0.45,4,2999,1,1,1,0,0.0,0.0,0.0,4.0,1199,209,1408
3000,0.8,0.45,5,2999,1,1,1,0,0.0,0.0,0.0,2.0,1199,209,1408
3000,0.8,0.45,6,2999,1,1,1,0,0.0,0.0,0.0,2.0,1199,209,1408
3000,0.8,0.5,3,2999,1,1,0,1,0.0,0.0,0.0,0,1199,210,1409
3000,0.8,0.5,4,2999,1,1,1,0,0.0,0.0,0.0,2.0,1199,209,1408
3000,0.8,0.5,5,2999,1,1,1,0,0.0,0.0,0.0,2.0,1199,209,1408
3000,0.8,0.5,6,2999,1,1,1,0,0.0,0.0,0.0,5.0,1199,209,1408
3000,0.8,0.55,3,2999,1,1,0,1,0.0,0.0,0.0,0,1199,210,1409
3000,0.8,0.55,4,2999,1,1,0,1,0.0,0.0,0.0,0,1199,210,1409
3000,0.8,0.55,5,2999,1,1,1,0,0.0,0.0,0.0,5.0,1199,209,1408
3000,0.8,0.55,6,2999,1,1,1,0,0.0,0.0,0.0,2.0,1199,209,1408
3000,0.8,0.6,3,549,2451,2451,830,1621,0.82,0.82,0.28,2.91,1251,620,1871
3000,0.8,0.6,4,574,2426,2426,1084,1342,0.81,0.81,0.36,3.32,1226,874,2100
3000,0.8,0.6,5,554,2446,2446,1265,1181,0.82,0.82,0.42,3.65,1246,1055,2301
3000,0.8,0.6,6,551,2449,2449,1372,1077,0.82,0.82,0.46,4.03,1249,1162,2411
3000,0.85,0.3,3,2999,1,1,1,0,0.0,0.0,0.0,3.0,1199,209,1408
3000,0.85,0.3,4,2999,1,1,0,1,0.0,0.0,0.0,0,1199,210,1409
3000,0.85,0.3,5,2999,1,1,1,0,0.0,0.0,0.0,3.0,1199,209,1408
3000,0.85,0.3,6,2999,1,1,0,1,0.0,0.0,0.0,0,1199,210,1409
3000,0.85,0.35,3,2999,1,1,0,1,0.0,0.0,0.0,0,1199,210,1409
3000,0.85,0.35,4,2999,1,1,0,1,0.0,0.0,0.0,0,1199,210,1409
3000,0.85,0.35,5,2999,1,1,0,1,0.0,0.0,0.0,0,1199,210,1409
3000,0.85,0.35,6,2999,1,1,1,0,0.0,0.0,0.0,3.0,1199,209,1408
3000,0.85,0.4,3,2999,1,1,0,1,0.0,0.0,0.0,0,1199,210,1409
3000,0.85,0.4,4,2999,1,1,1,0,0.0,0.0,0.0,4.0,1199,209,1408
3000,0.85,0.4,5,2999,1,1,1,0,0.0,0.0,0.0,5.0,1199,209,1408
3000,0.85,0.4,6,2999,1,1,1,0,0.0,0.0,0.0,4.0,1199,209,1408
3000,0.85,0.45,3,2999,1,1,0,1,0.0,0.0,0.0,0,1199,210,1409
3000,0.85,0.45,4,2999,1,1,0,1,0.0,0.0,0.0,0,1199,210,1409
3000,0.85,0.45,5,2999,1,1,1,0,0.0,0.0,0.0,4.0,1199,209,1408
3000,0.85,0.45,6,2999,1,1,1,0,0.0,0.0,0.0,3.0,1199,209,1408
3000,0.85,0.5,3,2999,1,1,0,1,0.0,0.0,0.0,0,1199,210,1409
3000,0.85,0.5,4,2999,1,1,1,0,0.0,0.0,0.0,4.0,1199,209,1408
3000,0.85,0.5,5,2999,1,1,1,0,0.0,0.0,0.0,5.0,1199,209,1408
3000,0.85,0.5,6,2999,1,1,1,0,0.0,0.0,0.0,4.0,1199,209,1408
3000,0.85,0.55,3,2999,1,1,0,1,0.0,0.0,0.0,0,1199,210,1409
3000,0.85,0.55,4,2999,1,1,0,1,0.0,0.0,0.0,0,1199,210,1409
3000,0.85,0.55,5,2999,1,1,1,0,0.0,0.0,0.0,4.0,1199,209,1408
3000,0.85,0.55,6,2999,1,1,1,0,0.0,0.0,0.0,3.0,1199,209,1408
3000,0.85,0.6,3,489,2511,2511,959,1552,0.84,0.84,0.32,2.89,1311,749,2060
3000,0.85,0.6,4,475,2525,2525,1201,1324,0.84,0.84,0.4,3.33,1325,991,2316
3000,0.85,0.6,5,475,2525,2525,1293,1232,0.84,0.84,0.43,3.71,1325,1083,2408
3000,0.85,0.6,6,469,2531,2531,1495,1036,0.84,0.84,0.5,4.05,1331,1285,2616
3000,0.9,0.3,3,2999,1,1,0,1,0.0,0.0,0.0,0,1199,210,1409
3000,0.9,0.3,4,2999,1,1,0,1,0.0,0.0,0.0,0,1199,210,1409
3000,0.9,0.3,5,2999,1,1,0,1,0.0,0.0,0.0,0,1199,210,1409
3000,0.9,0.3,6,2999,1,1,1,0,0.0,0.0,0.0,3.0,1199,209,1408
3000,0.9,0.35,3,2999,1,1,0,1,0.0,0.0,0.0,0,1199,210,1409
3000,0.9,0.35,4,2999,1,1,1,0,0.0,0.0,0.0,4.0,1199,209,1408
3000,0.9,0.35,5,2999,1,1,1,0,0.0,0.0,0.0,2.0,1199,209,1408
3000,0.9,0.35,6,2999,1,1,1,0,0.0,0.0,0.0,6.0,1199,209,1408
3000,0.9,0.4,3,2999,1,1,0,1,0.0,0.0,0.0,0,1199,210,1409
3000,0.9,0.4,4,2999,1,1,1,0,0.0,0.0,0.0,4.0,1199,209,1408
3000,0.9,0.4,5,2999,1,1,1,0,0.0,0.0,0.0,4.0,1199,209,1408
3000,0.9,0.4,6,2999,1,1,1,0,0.0,0.0,0.0,7.0,1199,209,1408
3000,0.9,0.45,3,2999,1,1,1,0,0.0,0.0,0.0,2.0,1199,209,1408
3000,0.9,0.45,4,2999,1,1,1,0,0.0,0.0,0.0,4.0,1199,209,1408
3000,0.9,0.45,5,2999,1,1,1,0,0.0,0.0,0.0,5.0,1199,209,1408
3000,0.9,0.45,6,2999,1,1,1,0,0.0,0.0,0.0,2.0,1199,209,1408
3000,0.9,0.5,3,2999,1,1,0,1,0.0,0.0,0.0,0,1199,210,1409
3000,0.9,0.5,4,2999,1,1,0,1,0.0,0.0,0.0,0,1199,210,1409
3000,0.9,0.5,5,2999,1,1,1,0,0.0,0.0,0.0,4.0,1199,209,1408
3000,0.9,0.5,6,2999,1,1,1,0,0.0,0.0,0.0,2.0,1199,209,1408
3000,0.9,0.55,3,2999,1,1,0,1,0.0,0.0,0.0,0,1199,210,1409
3000,0.9,0.55,4,2999,1,1,0,1,0.0,0.0,0.0,0,1199,210,1409
3000,0.9,0.55,5,2999,1,1,1,0,0.0,0.0,0.0,4.0,1199,209,1408
3000,0.9,0.55,6,2999,1,1,0,1,0.0,0.0,0.0,0,1199,210,1409
3000,0.9,0.6,3,422,2578,2578,942,1636,0.86,0.86,0.31,2.91,1378,732,2110
3000,0.9,0.6,4,411,2589,2589,1163,1426,0.86,0.86,0.39,3.34,1389,953,2342
3000,0.9,0.6,5,416,2584,2584,1355,1229,0.86,0.86,0.45,3.68,1384,1145,2529
3000,0.9,0.6,6,406,2594,2594,1498,1096,0.86,0.86,0.5,4.01,1394,1288,2682
3000,0.95,0.3,3,2999,1,1,1,0,0.0,0.0,0.0,2.0,1199,209,1408
3000,0.95,0.3,4,2999,1,1,1,0,0.0,0.0,0.0,2.0,1199,209,1408
3000,0.95,0.3,5,2999,1,1,1,0,0.0,0.0,0.0,4.0,1199,209,1408
3000,0.95,0.3,6,2999,1,1,1,0,0.0,0.0,0.0,4.0,1199,209,1408
3000,0.95,0.35,3,2999,1,1,0,1,0.0,0.0,0.0,0,1199,210,1409
3000,0.95,0.35,4,2999,1,1,1,0,0.0,0.0,0.0,2.0,1199,209,1408
3000,0.95,0.35,5,2999,1,1,0,1,0.0,0.0,0.0,0,1199,210,1409
3000,0.95,0.35,6,2999,1,1,1,0,0.0,0.0,0.0,4.0,1199,209,1408
3000,0.95,0.4,3,2999,1,1,0,1,0.0,0.0,0.0,0,1199,210,1409
3000,0.95,0.4,4,2999,1,1,1,0,0.0,0.0,0.0,4.0,1199,209,1408
3000,0.95,0.4,5,2999,1,1,1,0,0.0,0.0,0.0,2.0,1199,209,1408
3000,0.95,0.4,6,2999,1,1,0,1,0.0,0.0,0.0,0,1199,210,1409
3000,0.95,0.45,3,2999,1,1,0,1,0.0,0.0,0.0,0,1199,210,1409
3000,0.95,0.45,4,2999,1,1,0,1,0.0,0.0,0.0,0,1199,210,1409
3000,0.95,0.45,5,2999,1,1,1,0,0.0,0.0,0.0,5.0,1199,209,1408
3000,0.95,0.45,6,2999,1,1,1,0,0.0,0.0,0.0,2.0,1199,209,1408
3000,0.95,0.5,3,2999,1,1,1,0,0.0,0.0,0.0,4.0,1199,209,1408
3000,0.95,0.5,4,2999,1,1,0,1,0.0,0.0,0.0,0,1199,210,1409
3000,0.95,0.5,5,2999,1,1,1,0,0.0,0.0,0.0,4.0,1199,209,1408
3000,0.95,0.5,6,2999,1,1,1,0,0.0,0.0,0.0,4.0,1199,209,1408
3000,0.95,0.55,3,2999,1,1,1,0,0.0,0.0,0.0,2.0,1199,209,1408
3000,0.95,0.55,4,2999,1,1,1,0,0.0,0.0,0.0,2.0,1199,209,1408
3000,0.95,0.55,5,2999,1,1,0,1,0.0,0.0,0.0,0,1199,210,1409
3000,0.95,0.55,6,2999,1,1,1,0,0.0,0.0,0.0,4.0,1199,209,1408
3000,0.95,0.6,3,2999,1,1,0,1,0.0,0.0,0.0,0,1199,210,1409
3000,0.95,0.6,4,2999,1,1,1,0,0.0,0.0,0.0,4.0,1199,209,1408
3000,0.95,0.6,5,2999,1,1,1,0,0.0,0.0,0.0,2.0,1199,209,1408
3000,0.95,0.6,6,2999,1,1,0,1,0.0,0.0,0.0,0,1199,210,1409
3000,0.99,0.3,3,2999,1,1,0,1,0.0,0.0,0.0,0,1199,210,1409
3000,0.99,0.3,4,2999,1,1,0,1,0.0,0.0,0.0,0,1199,210,1409
3000,0.99,0.3,5,2999,1,1,1,0,0.0,0.0,0.0,5.0,1199,209,1408
3000,0.99,0.3,6,2999,1,1,1,0,0.0,0.0,0.0,2.0,1199,209,1408
3000,0.99,0.35,3,2999,1,1,1,0,0.0,0.0,0.0,4.0,1199,209,1408
3000,0.99,0.35,4,2999,1,1,0,1,0.0,0.0,0.0,0,1199,210,1409
3000,0.99,0.35,5,2999,1,1,1,0,0.0,0.0,0.0,4.0,1199,209,1408
3000,0.99,0.35,6,2999,1,1,1,0,0.0,0.0,0.0,4.0,1199,209,1408
3000,0.99,0.4,3,2999,1,1,1,0,0.0,0.0,0.0,2.0,1199,209,1408
3000,0.99,0.4,4,2999,1,1,1,0,0.0,0.0,0.0,2.0,1199,209,1408
3000,0.99,0.4,5,2999,1,1,0,1,0.0,0.0,0.0,0,1199,210,1409
3000,0.99,0.4,6,2999,1,1,1,0,0.0,0.0,0.0,4.0,1199,209,1408
3000,0.99,0.45,3,2999,1,1,0,1,0.0,0.0,0.0,0,1199,210,1409
3000,0.99,0.45,4,2999,1,1,1,0,0.0,0.0,0.0,4.0,1199,209,1408
3000,0.99,0.45,5,2999,1,1,1,0,0.0,0.0,0.0,2.0,1199,209,1408
3000,0.99,0.45,6,2999,1,1,0,1,0.0,0.0,0.0,0,1199,210,1409
3000,0.99,0.5,3,2999,1,1,0,1,0.0,0.0,0.0,0,1199,210,1409
3000,0.99,0.5,4,2999,1,1,0,1,0.0,0.0,0.0,0,1199,210,1409
3000,0.99,0.5,5,2999,1,1,1,0,0.0,0.0,0.0,5.0,1199,209,1408
3000,0.99,0.5,6,2999,1,1,1,0,0.0,0.0,0.0,2.0,1199,209,1408
3000,0.99,0.55,3,2999,1,1,1,0,0.0,0.0,0.0,4.0,1199,209,1408
3000,0.99,0.55,4,2999,1,1,0,1,0.0,0.0,0.0,0,1199,210,1409
3000,0.99,0.55,5,2999,1,1,1,0,0.0,0.0,0.0,4.0,1199,209,1408
3000,0.99,0.55,6,2999,1,1,1,0,0.0,0.0,0.0,4.0,1199,209,1408
3000,0.99,0.6,3,2999,1,1,1,0,0.0,0.0,0.0,2.0,1199,209,1408
3000,0.99,0.6,4,2999,1,1,1,0,0.0,0.0,0.0,2.0,1199,209,1408
3000,0.99,0.6,5,2999,1,1,0,1,0.0,0.0,0.0,0,1199,210,1409
3000,0.99,0.6,6,2999,1,1,1,0,0.0,0.0,0.0,4.0,1199,209,1408
